// This is a comment
// All the level designs are created here. The code and puzzles are in the individual python files.
// # - rocks
// @ - dead vines
// & - next level/room door
// ! - movable object
// [empty] - ground

// Level One
###############
#             #
#             #
#             #
#             #
#             
#             
#             
#             
#             #
#             #
#             #
#             #
###############

// Level Two
#####     #####
#             #
#             #
#             #
#             #
              #
              #
              #
              #
#             #
#             #
#             #
#             #
###############

// Level Three
###############
#             #
#             #
#             #
#             #
              #
              #
              #
              #
#             #
#             #
#             #
#             #
#####     #####